R 1000 720

NO ../textures/redbrick.xpm
SO ../textures/colorstone.xpm
WE ../textures/greystone.xpm
EA ../textures/bluestone.xpm

S ./path_to_the_sprite_texture
F 220,100,0
C 225,30,100

111111111111111111111111111111111111111111111111111
100000000000000000000000000000000000000000000000001
100000000000000000000000000000000000000000000000001
100000000000000000000000000000000000000000000000001
100010000000000000000000000000000000000000000000001
100000000000000000000000000000000000000000000000001
100000000000000000000000000000000000000000000000001
100000000000000011111110001111110000000000000000001
100000000000000010000000000000010000000000000000001
100000000000000010000000000000010000000000000000001
100000000000000010000000000000010000000000000000001
100000000000000010000000000000010000000000000000001
100000000000000000000000000000000000000000000000001
100000000000000000000000E00000000000000000000000001
100000000000000000000000000000000000000000000000001
100000000000000010000000000000010000000000000000001
100000000000000010000000000000010000000000000000001
100000000000000010000000000000010000000000000000001
100000000000000010000000000000010000000000000000001
100000000000000010000000000000010000000000000000001
100000000000000011111110001111110000000000000000001
100000000000000000000000000000000000000000000000001
100000000000000000000000000000000000000000000000001
100000000000000000000000000000000000000000000000001
100000000000000000000000000000000000000000000000001
100000000000000000000000000000000000000000000000001
100000000000000000000000000000000000000000000000001
100000000000000000000000000000000000000000000000001
100000000000000000000000000000000000000000000000001
100000000000000000000000000000000000000000000000001
100000000000000000000000000000000000000000000000001
100000000000000000000000000000000000000000000000001
100000000000000000000000000000000000000000000000001
111111111111111111111111111111111111111111111111111