R 1080 720

NO ../textures/flat-rrock05.xpm
SO ../textures/flat-slime11.xpm
WE ../textures/flat-slime09.xpm
EA ../textures/flat-rrock08.xpm

S ../textures/barrel.xpm
F 162,101,62
C 0,0,102

11111111111111111
12022022022022021
12022022022022021
12022022N22022021
12022022022022021
12022022022022021
12022022022022021
12022022022022021
12022022022022021
12022022022022021
12022022022022021
12022022022022021
12022022022022021
12022022022022021
12022022022022021
12022022022022021
12022022022022021
12022022022022021
12022022022022021
12022022022022021
12022022022022021
12022022022022021
12022022022022021
12022022022022021
12022022022022021
12022022022022021
12022022022022021
12022022022022021
12022022022022021
12022022022022021
12022022022022021
12022022022022021
12022022022022021
12022022022022021
12022022022022021
12022022022022021
12022022022022021
12022022022022021
12022022022022021
12022022022022021
12022022022022021
12022022022022021
12022022022022021
12022022022022021
12022022022022021
12022022022022021
12022022022022021
12022022022022021
12022022022022021
12022022022022021
12022022022022021
12022022022022021
12022022022022021
12022022022022021
12022022022022021
12022022022022021
12022022022022021
12022022022022021
12022022022022021
12022022022022021
12022022022022021
12022022022022021
12022022022022021
12022022022022021
12022022022022021
12022022022022021
12022022022022021
12022022022022021
12022022022022021
12022022022022021
12022022022022021
12022022022022021
12022022022022021
12022022022022021
12022022022022021
12022022022022021
12022022022022021
12022022022022021
12022022022022021
12022022022022021
12022022022022021
12022022022022021
12022022022022021
12022022022022021
12022022022022021
12022022022022021
12022022022022021
12022022022022021
12022022022022021
12022022022022021
12022022022022021
12022022022022021
12022022022022021
12022022022022021
12022022022022021
12022022022022021
12022022022022021
12022022022022021
12022022022022021
12022022022022021
12022022022022021
12022022022022021
12022022022022021
12022022022022021
12022022022022021
12022022022022021
12022022022022021
12022022022022021
12022022022022021
12022022022022021
12022022022022021
12022022022022021
12022022022022021
12022022022022021
12022022022022021
12022022022022021
12022022022022021
12022022022022021
12022022022022021
12022022022022021
12022022022022021
12022022022022021
12022022022022021
12022022022022021
12022022022022021
12022022022022021
12022022022022021
12022022022022021
12022022022022021
12022022022022021
12022022022022021
12022022022022021
12022022022022021
12022022022022021
12022022022022021
12022022022022021
12022022022022021
12022022022022021
12022022022022021
12022022022022021
12022022022022021
12022022022022021
12022022022022021
12022022022022021
12022022022022021
12022022022022021
12022022022022021
12022022022022021
12022022022022021
12022022022022021
12022022022022021
12022022022022021
12022022022022021
12022022022022021
12022022022022021
12022022022022021
12022022022022021
12022022022022021
12022022022022021
12022022022022021
12022022022022021
12022022022022021
12022022022022021
12022022022022021
12022022022022021
12022022022022021
12022022022022021
12022022022022021
12022022022022021
12022022022022021
12022022022022021
12022022022022021
12022022022022021
12022022022022021
12022022022022021
12022022022022021
12022022022022021
12022022022022021
12022022022022021
12022022022022021
12022022022022021
12022022022022021
12022022022022021
12022022022022021
12022022022022021
12022022022022021
12022022022022021
12022022022022021
12022022022022021
12022022022022021
12022022022022021
12022022022022021
12022022022022021
12022022022022021
12022022022022021
12022022022022021
12022022022022021
12022022022022021
12022022022022021
12022022022022021
12022022022022021
12022022022022021
12022022022022021
10000000000000001
10200200200200201
10000000000000001
10000000000000001
10000000000000001
10000000000000001
10000000000000001
10000000000000001
10000000000000001
10000000000000001
10000000000000001
10000000000000001
10000000000000001
10000000000000001
10000000000000001
10000000000000001
10000000000000001
10000000000000001
10000000000000001
10000000000000001
10000000000000001
10000000000000001
10000000000000001
10000000000000001
10000000000000001
10000000000000001
10000000000000001
10000000000000001
10000000000000001
10000000000000001
10000000000000001
10000000000000001
10000000000000001
10000000000000001
10000000000000001
10000000000000001
10000000000000001
10000000000000001
10000000000000001
10000000000000001
10000000000000001
10000000000000001
10000000000000001
10000000000000001
10000000000000001
10000000000000001
10000000000000001
10000000000000001
10000000000000001
10000000000000001
10000000000000001
10000000000000001
10000000000000001
10000000000000001
10000000000000001
10000000000000001
10000000000000001
10000000000000001
10000000000000001
10000000000000001
10000000000000001
10000000000000001
10000000000000001
10000000000000001
10000000000000001
10000000000000001
10000000000000001
10000000000000001
10000000000000001
10000000000000001
10000000000000001
10000000000000001
10000000000000001
10000000000000001
10000000000000001
10000000000000001
10000000000000001
10000000000000001
10000000000000001
10000000000000001
10000000000000001
10000000000000001
10000000000000001
10000000000000001
10000000000000001
10000000000000001
10000000000000001
10000000000000001
10000000000000001
10000000000000001
10000000000000001
10000000000000001
10000000000000001
10000000000000001
10000000000000001
10000000000000001
10000000000000001
10000000000000001
10000000000000001
10000000000000001
10000000000000001
10000000000000001
10000000000000001
10000000000000001
10000000000000001
10000000000000001
10000000000000001
10000000000000001
10000000000000001
10000000000000001
10000000000000001
10000000000000001
10000000000000001
10000000000000001
10000000000000001
10000000000000001
10000000000000001
10000000000000001
10000000000000001
10000000000000001
10000000000000001
10000000000000001
10000000000000001
10000000000000001
10000000000000001
10000000000000001
10000000000000001
10000000000000001
10000000000000001
10000000000000001
10000000000000001
10000000000000001
10000000000000001
10000000000000001
10000000000000001
10000000000000001
10000000000000001
10000000000000001
10000000000000001
10000000000000001
10000000000000001
10000000000000001
10000000000000001
10000000000000001
10000000000000001
10000000000000001
10000000000000001
10000000000000001
10000000000000001
10000000000000001
10000000000000001
10000000000000001
10000000000000001
10000000000000001
10000000000000001
10000000000000001
10000000000000001
10000000000000001
10000000000000001
10000000000000001
10000000000000001
10000000000000001
10000000000000001
10000000000000001
10000000000000001
10000000000000001
10000000000000001
10000000000000001
10000000000000001
10000000000000001
10000000000000001
10000000000000001
10000000000000001
10000000000000001
10000000000000001
10000000000000001
10000000000000001
10000000000000001
10000000000000001
10000000000000001
10000000000000001
10000000000000001
10000000000000001
10000000000000001
10000000000000001
10000000000000001
10000000000000001
10000000000000001
10000000000000001
10000000000000001
10000000000000001
10000000000000001
10000000000000001
10000000000000001
10000000000000001
10000000000000001
10000000000000001
10000000000000001
10000000000000001
10000000000000001
10000000000000001
10000000000000001
10000000000000001
10000000000000001
10000000000000001
10000000000000001
10000000000000001
10000000000000001
10000000000000001
10000000000000001
10000000000000001
10000000000000001
10000000000000001
10000000000000001
10000000000000001
10000000000000001
10000000000000001
10000000000000001
10000000000000001
10000000000000001
10000000000000001
10000000000000001
10000000000000001
10000000000000001
10000000000000001
10000000000000001
10000000000000001
10000000000000001
10000000000000001
10000000000000001
10000000000000001
10000000000000001
10000000000000001
10000000000000001
10000000000000001
10000000000000001
10000000000000001
10000000000000001
10000000000000001
10000000000000001
10000000000000001
10000000000000001
10000000000000001
10000000000000001
10000000000000001
10000000000000001
10000000000000001
10000000000000001
10000000000000001
10000000000000001
10000000000000001
10000000000000001
10000000000000001
10000000000000001
10000000000000001
10000000000000001
10000000000000001
10000000000000001
10000000000000001
10000000000000001
10000000000000001
10000000000000001
10000000000000001
10000000000000001
10000000000000001
10000000000000001
10000000000000001
10000000000000001
10000000000000001
10000000000000001
10000000000000001
10000000000000001
10000000000000001
10000000000000001
10000000000000001
10000000000000001
10000000000000001
10000000000000001
10000000000000001
10000000000000001
10000000000000001
10000000000000001
10000000000000001
10000000000000001
10000000000000001
10000000000000001
10000000000000001
10000000000000001
10000000000000001
10000000000000001
10000000000000001
10000000000000001
10000000000000001
10000000000000001
10000000000000001
10000000000000001
10000000000000001
10000000000000001
10000000000000001
10000000000000001
10000000000000001
10000000000000001
10000000000000001
10000000000000001
10000000000000001
10000000000000001
10000000000000001
10000000000000001
10000000000000001
10000000000000001
10000000000000001
10000000000000001
10000000000000001
10000000000000001
10000000000000001
10000000000000001
10000000000000001
10000000000000001
10000000000000001
10000000000000001
10000000000000001
10000000000000001
10000000000000001
10000000000000001
10000000000000001
10000000000000001
10000000000000001
10000000000000001
10000000000000001
10000000000000001
10000000000000001
10000000000000001
10000000000000001
10000000000000001
10000000000000001
10000000000000001
10000000000000001
10000000000000001
10000000000000001
10000000000000001
10000000000000001
10000000000000001
10000000000000001
10000000000000001
10000000000000001
10000000000000001
10000000000000001
10000000000000001
10000000000000001
10000000000000001
10000000000000001
10000000000000001
10000000000000001
10000000000000001
11111111111111111