R 1080 1000

NO ./textures/flat-rrock05.xpm
WE ./textures/flat-rrock08.xpm
EA ./textures/flat-slime09.xpm
SO ./textures/flat-slime11.xpm

S ./textures/barrel.xpm
F 162,101,62
C 0,0,102

111111111111111111111111111111111111111111111111111
100000000000000000000000000000000000000000000000001
100000000000000000000000000000000000000000000000001
100000000000000000000000000000000000000000000000001
100010000000000000000000000000000000000000000000001
100000000000000000000000000000000000000000000000001
100000000000000000000000000000000000000000000000001
100000000000000011111100000111110000000000000000001
100000000000000010000000000000010000000000000000001
100000000000000010000000000000010000000000000000001
100000000000000010000200000200010000000000000000001
100000000000000000000000000000000000000000000000001
100000000000000000000000000000000000000000000000001
100000000000000000000000000000000000000000000000001
100000000000000000000000N00000000000000000000000001
100000000000000000000000000000000000000000000000001
100000000000000000000000000000000000000000000000001
100000000000000010000000000000010000000000000000001
100000000000000010000000000000010000000000000000001
100000000000000010000000000000010000000000000000001
100000000000000010000000000000010000000000000000001
100000000000000011111110001111110000000000000000001
100000000000000000000000000000000000000000000000001
100000000000000000000000000000000000000000000000001
100000000000000000000000000000000000000000000000001
100000000000000000000000000000000000000000000000001
100000000000000000000000000000000000000000000000001
100000000000000000000000000000000000000000000000001
100000000000000000000000000000000000000000000000001
100000000000000000000000000000000000000000000000001
100000000000000000000000000000000000000000000000001
100000000000000000000000000000000000000000000000001
100000000000000000000000000000000000000000000000001
100000000000000000000000000000000000000000000000001
111111111111111111111111111111111011111111111111111
         111111111111111111111111011111111
         100010000000000010001000000000001
         101010101010101110101010101010101
         101010101010101010101010101010101
         101000101000100010100010100010001
         101111101011101110111110101110111
         100010001000000010001000100000001
         101010101110111010101010111011101
         101010101000100010101010100010001
         101010101010101010101010101010101
         101000101000001010100010100000101
         100010000000000010001000000000001
         101010101010101110101010101010101
         101010101010101010101010101010101
         101000101000100010100010100010001
         101111111011101010111110101110111
         100010001000000010001000100000001
         101010101110111010101010111011101
         101010101000100010101010100010001
         101010101010101010101010101010101
         100000000000000000000000000000001
         111111111111111111111111111111111